###########
#A#       #
# # ##### #
# # #   # #
#   # # # #
### # # # #
#     #   #
# ##### ###       
#       B#
###########